5 10
|--------|
|GGG|..-.|
|GG-|.@P.|
|..G...-.|
|--------|